Abandoned Heart|ABAN|cyclic
Absolution|ABSOLUTION|ritual
Acid Splash|ACS|battle
Aegis of Granite|AEG|ritual
Aesandry Darlaeth|AD|cyclic
Aesrela Everild|AE|battle
Aether Cloak|AC|cyclic
Aether Wolves|AEWO|cyclic
Aethrolysis|AETHROLYSIS|battle
Aggressive Stance|AGS|standard
Air Bubble|AB|standard
Air Lash|ALA|battle
Alamhif's Gift|AG|ritual
Albreda's Balm|ALB|cyclic
Alkahest Edge|ALK|metamagic
Anther's Call|ANC|battle
Anti-Stun|AS|battle
Arbiter's Stylus|ARS|cyclic
Arc Light|AL|battle
Artificer's Eye|ART|standard
Aspects of the All-God|ALL|ritual
Aspirant's Aegis|AA|standard
Athleticism|ATHLETICISM|standard
Aura of Tongues|AOT|standard
Aura Sight|AUS|standard
Auspice|AUSPICE|standard
Avren Aevareae|AVA|standard
Avtalia Array|AVTA|metamagic
Awaken|AWAKEN|battle
Awaken Forest|AF|cyclic
Banner of Truce|BOT|standard
Bear Strength|BES|cyclic
Beckon the Naga|BTN|standard
Benediction|BENEDICTION|standard
Bespoke Regalia|BESPOKEREGALIA|metamagic
Bitter Feast|BF|metamagic
Blend|BLEND|standard
Bless|BLESS|standard
Blessing of the Fae|BOTF|cyclic
Blood Burst|BLB|battle
Blood Staunching|BS|standard
Bloodthorns|BLOODTHORNS|ritual
Blufmor Garaen|BG|battle
Blur|BLUR|standard
Bond Armaments|BA|standard
Braun's Conjecture|BC|ritual
Breath of Storms|BOS|battle
Burden|BURDEN|battle
Burn|BURN|battle
Butcher's Eye|BUE|standard
Cage of Light|COL|standard
Calcified Hide|CH|standard
Call from Beyond|CFB|standard
Calm|CALM|battle
Caress of the Sun|CARE|cyclic
Carrion Call|CAC|battle
Centering|CENTERING|standard
Chain Lightning|CL|battle
Cheetah Swiftness|CS|cyclic
Chill Spirit|CHS|battle
Chirurgia|CHIR|metamagic
Circle of Sympathy|COS|ritual
Clarity|CLARITY|standard
Claws of the Cougar|COTC|standard
Clear Vision|CV|standard
Compel|COMPEL|battle
Compost|COMPOST|standard
Consume Flesh|CF|standard
Contingency|CONTINGENCY|standard
Courage|COURAGE|standard
Covetous Rebirth|CRE|metamagic
Crusader's Challenge|CRC|battle
Crystal Dart|CRD|battle
Cure Disease|CD|standard
Curse of the Wilds|COTW|battle
Curse of Zachriedek|COZ|battle
Damaris' Lullaby|DALU|cyclic
Dazzle|DAZZLE|battle
Deadfall|DF|battle
Demrris' Resolve|DMRS|battle
Desert's Maelstrom|DEMA|battle
Destiny Cipher|DC|ritual
Devitalize|DEVI|battle
Devolve|DE|battle
Devour|DEVOUR|standard
Dinazen Olkar|DO|battle
Dispel|DISPEL|battle
Distant Gaze|DG|standard
Divine Armor|DA|standard
Divine Guidance|DIG|standard
Divine Radiance|DR|standard, battle
Dragon's Breath|DB|battle
Drums of the Snake|DRUM|standard
Eagle's Cry|EC|battle
Earth Meld|EM|standard
Ease Burden|EASE|standard
Ebon Blood of the Scorpion|EBOTS|metamagic
Echoes of Aether|ECHO|ritual
Eillie's Cry|ECRY|standard
Electrostatic Eddy|EE|cyclic
Elementalism|ELEMENTALISM|metamagic
Elision|ELI|ritual
Empower Moonblade|EMMO|metamagic
Emuin's Candlelight|EMC|standard
Enrichment|ENRICHMENT|battle
Essence of Yew|EY|standard
Ethereal Fissure|ETF|standard
Ethereal Shield|ES|standard
Expansive Infusions|EXPANSIVEINFUSIONS|metamagic
Eye of Kertigen|EYE|cyclic
Eyes of the Blind|EOTB|standard
Eylhaar's Feast|EF|battle
Faenella's Grace|FAE|cyclic
Fiery Infusions|FIERYINFUSIONS|metamagic
Finesse|FIN|standard
Fire Ball|FB|battle
Fire of Ushnish|FOU|battle
Fire Rain|FR|cyclic
Fire Shards|FS|battle
Fists of Faenella|FF|battle
Flame Shockwave|FLS|metamagic
Fluoresce|FLU|battle
Flush Poisons|FP|standard
Focus Moonbeam|FM|standard
Footman's Strike|FST|battle
Forestwalker's Boon|FWB|battle
Fortress of Ice|FOI|standard
Fountain of Creation|FOC|standard
Frost Scythe|FRS|battle
Frostbite|FROSTBITE|battle
Gam Irnan|GI|standard
Gar Zeng|GZ|battle
Geyser|GEYSER|battle
Ghost Shroud|GHS|cyclic
Ghoulflesh|GHOULFLESH|standard
Gift of Life|GOL|standard
Glythtide's Gift|GG|standard
Glythtide's Joy|GJ|cyclic
Grizzly Claws|GRIZ|battle
Grounding Field|GF|standard
Guage Flow|GAF|standard
Guardian Spirit|GS|cyclic
Halo|HALO|battle
Halt|HALT|battle
Hand of Tenemlor|HOT|battle
Hands of Justice|HOJ|standard
Hands of Lirisa|HOL|standard
Harawep's Bonds|HB|battle
Harm Evil|HE|battle
Harm Horde|HH|battle
Harmony|HARM|standard
Heal|HEAL|standard
Heal Scars|HS|standard
Heal Wounds|HW|standard
Heart Link|HL|standard
Heavenly Fires|HF|metamagic
Heighten Pain|HP|battle
Heroic Strength|HES|standard
Hodierna's Lilt|HODI|cyclic
Holy Warrior|HOW|cyclic
Horn of the Black Unicorn|HORN|battle
Huldah's Pall|HULP|battle
Hydra Hex|HYH|cyclic
Hypnotize|HYPNOTIZE|metamagic
Ice Patch|IP|battle
Icutu Zaharenela|IZ|cyclic
Icy Infusions|ICYINFUSIONS|metamagic
Idon's Theft|IT|battle
Ignite|IGNITE|standard
Ignition Point|IGNITIONPOINT|metamagic
Imbue|IMBUE|standard
Innocence|INNOCENCE|standard
Instinct|INST|standard
Invocation of the Spheres|IOTS|ritual
Iron Constitution|IC|standard
Ivory Mask|IVM|standard
Iyqaromos Fire-Lens|IFL|metamagic
Kura-Silma|KS|standard
Last Gift of Vithwok IV|LGV|standard
Lay Ward|LW|battle
Lethargy|LETHARGY|battle
Lightning Bolt|LB|battle
Liturgy|LITURGY|metamagic
Locate|LOCATE|standard
Machinist's Touch|MT|standard
Magnetic Ballista|MAB|standard
Major Physical Protection|MAPP|standard
Malediction|MALEDICTION|battle
Manifest Force|MAF|standard
Mantle of Flame|MOF|ritual
Mark of Arhat|MOA|battle
Marshal Order|MO|standard
Mask of the Moons|MOM|cyclic
Mass Rejuvenation|MRE|standard
Membrach's Greed|MEG|standard
Memory of Nature|MON|ritual
Mental Blast|MB|battle
Mental Focus|MEF|standard
Meraud's Cry|MC|battle
Mind Shout|MS|battle
Minor Physical Protection|MPP|standard
Misdirection|MIS|battle
Moonblade|MOONBLADE|battle
Moongate|MG|cyclic
Murrula's Flames|MF|ritual
Naming of Tears|NAME|standard
Necrotic Reconstruction|NR|standard
Nexus|NEXUS|standard
Nissa's Binding|NB|battle
Nonchalance|NON|standard
Noumena|NOU|standard
Oath of the Firstborn|OATH|standard
Obfuscation|OBFUSCATION|standard
Osrel Meraud|OM|standard
Paeldryth's Wrath|PW|battle
Paralysis|PARALYSIS|battle
Partial Displacement|PD|battle
Perseverance of Peri'el|POP|ritual
Persistence of Mana|POM|ritual
Petrifying Visions|PV|battle
Phelim's Sanction|PS|battle
Philosopher's Preservation|PHP|standard
Phoenix's Pyre|PYRE|cyclic
Piercing Gaze|PG|standard
Plague of Scavengers|PLS|metamagic
Platinum Hands of Kertigen|PHK|standard
Protection from Evil|PFE|standard
Psychic Shield|PSY|battle
Quick Infusions|QUICKINFUSIONS|metamagic
Quicken the Earth|QE|standard
Rage of the Clans|RAGE|standard
Raise Power|RP|standard
Read the Ripples|RTR|ritual
Rebuke|REB|battle
Redeemer's Pride|REPR|standard
Refractive Field|RF|standard
Refresh|REFRESH|standard
Regalia|REGA|battle
Regenerate|REGENERATE|cyclic
Reinforced Infusions|REINFORCEDINFUSIONS|metamagic
Rejuvenation|REJUV|standard
Rend|REND|battle
Researcher's Insight|REI|standard
Resonance|RESONANCE|standard
Resumption|RESUM|metamagic
Resurrection|REZZ|cyclic
Revelation|REV|cyclic
Reverse Putrefaction|RPU|standard
Riftal Summons|RS|standard
Righteous Wrath|RW|standard
Rimefang|RIM|cyclic
Ring of Spears|ROS|cyclic
Ripplegate Theory|RT|metamagic
Rising Mists|RM|standard
Rite of Contrition|ROC|cyclic
Rite of Forbearance|ROF|cyclic
Rite of Grace|ROG|cyclic
River in the Sky|RITS|standard
Rutilor's Edge|RUE|battle
Saesordian Compass|SCO|standard
Sanctify Pattern|SAP|standard
Sanctuary|SANCTUARY|cyclic
Sanyu Lyba|SL|battle
Seal Cambrinth|SEC|ritual
See the Wind|STW|standard
Seer's Sense|SEER|standard
Senses of the Tiger|SOTT|standard
Sentinel's Resolve|SR|standard
Sever Thread|SET|standard
Shadewatch Mirror|SHM|standard
Shadow Servant|SS|standard
Shadow Web|SHW|battle|cyclic
Shadowling|SHADOWLING|standard
Shadows|SHADOWS|standard
Shape Moonblade|SHMO|metamagic
Shatter|SHATTER|battle
Shear|SHEAR|battle
Shield of Light|SOL|battle
Shift Moonbeam|SM|standard
Shocking Infusions|SHOCKINGINFUSIONS|metamagic
Shockwave|SHOCKWAVE|battle
Siphon Vitality|SV|battle
Skein of Shadows|SKS|standard
Sleep|SLEEP|battle
Smite Horde|SMH|battle
Solace|SOLACE|standard
Soldier's Prayer|SP|battle
Soul Ablaze|SOUL|ritual
Soul Attrition|SA|cyclic
Soul Bonding|SB|battle
Soul Shield|SOS|standard
Soul Sickness|SICK|battle
Sovereign Destiny|SOD|battle
Spite of Dergati|SPIT|battle
Spiteful Rebirth|SRE|metamagic
Stampede|STAMPEDE|battle
Starcrash|STAR|battle
Starlight Sphere|SLS|cyclic, battle
Stellar Collector|STC|standard
Steps of Vuan|SOV|cyclic
Stone Strike|STS|battle
Strange Arrow|STRA|battle
Stun Foe|SF|battle
Substratum|SUBSTRATUM|standard
Sure Footing|SUF|standard
Swarm|SWARM|battle
Swirling Winds|SW|standard
Syamelyo Kuniyo|SK|battle
Tailwind|TW|standard
Tamsine's Kiss|TK|standard
Tangled Fate|TF|standard
Telekinetic Shield|TKSH|standard
Telekinetic Storm|TKS|battle
Telekinetic Throw|TKT|battle
Teleport|TELEPORT|standard
Tenebrous Sense|TS|standard
Tezirah's Veil|TV|battle
Thoughtcast|TH|standard
Thunderclap|TC|battle
Time of the Red Spiral|TOTRS|metamagic
Tingle|TI|battle
Trabe Chalice|TRC|standard
Tranquility|TRANQUILITY|standard
Tremor|TREM|battle
Truffenyi's Rally|TR|cyclic
Turmar Illumination|TURI|standard
Uncurse|UNCURSE|battle
Universal Solvent|USOL|cyclic
Unleash|UNLEASH|standard
Veil of Ice|VOI|standard
Vertigo|VERTIGO|battle
Vessel of Salvation|VOS|standard
Veteran Insight|VETERAN|metamagic
Vigil|VIGIL|standard
Vigor|VIGOR|standard
Viscous Solution|VS|standard
Visions of Darkness|VOD|battle
Vitality Healing|VH|standard
Vivisection|VIVISECTION|battle
Ward Break|WB|battle
Whispers of the Muse|WOTM|standard
Whole Displacement|WD|battle
Will of Winter|WILL|ritual
Wisdom of the Pack|WOTP|standard
Wolf Scent|WS|standard
Words of the Wind|WORD|ritual
Worm's Mist|WORM|battle
Y'ntrel Sechra|YS|standard
Zephyr|ZEPHYR|battle